R 1400   800

NO  ./xpm/walls/wood7.xpm
EA  ./xpm/walls/wood6.xpm
SO ./xpm/walls/wood5.xpm
WE ./xpm/walls/telep.xpm

S ./xpm/sprites/ball.xpm

C 100,100,69

F 0,0,255


11111111111111111
11111111111111111
10000000000000001
11111111111111111
11111111111111111
10000000000000001
12002002002002001
10000000000000001
1000000N000000001
11111111111111111