R 1400   800

NO  ./xpm/walls/wood7.xpm
WE  ./xpm/walls/black.xpm
SO ./xpm/walls/wood5.xpm
EA ./xpm/walls/wood4.xpm

S ./xpm/sprites/knight.xpm

C 100,100,69

F 0,0,255


111111111111111111111111111111111111111111111111
100000000000000000000000000000000000000000000001
100000000000000000000000000000000000000000000001
100000000000000000000000000000000000000000000001
120020020020020000000000000000000000000000000001
120020020020020000000000000000000000000000000001
100000000000000000000000000000000000000000000001
1000000N0000000000000000000000000000000000000001
100000000000000000000000000000000000000000000001
111111111111111111111111111111111111111111111111