
R 1000 500

NO  ./xpm/walls/wood3.xpm
EA  ./xpm/walls/wood.xpm
SO ./xpm/walls/wood2.xpm
WE ./xpm/walls/wood4.xpm

F 60,60,60
S ./xpm/sprites/scream.xpm


C 100,100,100

                         111111111
                        10000000001
                        10000000001
                         100000001
11111    111111111111111111000001
10001    100000020000000000000001
10011111101111111111111111000001
10001    100000020000000001111111
11011    111111111111111101                           111111
100011111110000000000000001                          10000001
10001000011011111111111111111111111111111           1000000001
1000000001101               1000000000001          100002000001
1000100001101               100000000000111111111110000000200001
100011111110111111          100000200000000000200000000002002001
100011000200200001          100000000000111111111110000000200001
100011000000000001          1000000000001          120000200001
10021100000000000111111111111000000000001           1000000001
10001100000000000000000000000000011111111            10000001
1000110000000000011111111111110001                    111111
100001200000000201           10001
100000000000000001           10001
100001000000000001           10001
100011000000000001           10001
100011000002000001          10001
100011000000000001         10001
100011000000000001        10001
100011111111111111       10001
10001            11111  10001
1001          11100000110001
101         110000020000001
101        10000000000000001
101       1000000000000000001
101111111100000000000000000001
100000000000200000000000002001
111111111100000000000000000001
          100000000W000000001
           10000000000000001
            110000020000011
              11100000111
                 11111